*****Interface / API / Column API*****

< Column Groups >

getColumnGroup : 주어진 이름의 열 그룹을 반환합니다.

getProvidedColumnGroup : 주어진 이름으로 제공된 열 그룹을 반환합니다.

setColumnGroupOpened : 열 그룹을 열거나 닫으려면 이것을 호출하십시오.


< Columns >

getColumn : (문자열) 또는 (객체) colKey가 될 수 있는 지정된 열을 반환합니다. colId colDef

getColumns : 표시 여부에 관계없이 모든 열을 반환합니다.

getAllGridColumns : getColumns() a) 그리드에 표시되는 열의 순서가 있음을 제외하고 모든 그리드 열을 반환합니다. 
                                 b) '피벗' 단계 이후이므로 피벗하는 경우 피벗에 대한 값 열이 있습니다.


< Moving >

moveColumn : 열을 toIndex로 이동합니다. 컬럼을 먼저 제거한 다음 해당 toIndex 위치에 추가하므로 제거 후 인덱스 위치가 컬럼의 오른쪽으로 변경됩니다.

moveColumns : moveColumn과 동일 하지만 목록에서 작동합니다.

moveColumnByIndex : moveColumn과 동일 하지만 인덱스 위치에서 작동합니다.


< Pinning >

isPinning : 왼쪽 또는 오른쪽으로 고정하면 true를 반환하고, 그렇지 않으면 false를 반환합니다.

isPinningLeft : 왼쪽으로 고정하면 true를 반환하고, 그렇지 않으면 false를 반환합니다.

isPinningRight : 오른쪽으로 고정하면 true를 반환하고 그렇지 않으면 false를 반환합니다.

setColumnPinned : 열 고정 / 고정 해제를 설정합니다. 키는 열 ID, 필드, ColDef 개체 또는 Column 개체일 수 있습니다.

setColumnsPinned : setColumnPinned 와 동일 하지만 열 키 목록을 제공합니다.


< Pivoting >

isPivotMode : 피벗 모드를 가져옵니다.

setPivotMode : 피벗 모드를 설정합니다.

getPivotColumns : 피벗 열을 가져옵니다.

setPivotColumns : 피벗 열을 설정합니다.

addPivotColumn : 피벗 열을 추가합니다.

addPivotColumns : addPivotColumn 과 동일 하지만 열 목록을 제공합니다.

removePivotColumn : 피벗 열을 제거합니다.

removePivotColumns : removePivotColumn 과 동일 하지만 열 목록을 제공합니다.

getPivotResultColumn : 주어진 pivotKeys 및 valueColId 에 대한 피벗 결과 열을 반환합니다. 그런 다음 피벗 열에서 작업을 호출하는 데 유용합니다.

setPivotResultColumns : 피벗 결과 열을 설정합니다.

getPivotResultColumns : 그리드의 피벗 결과 열을 반환합니다.


< Row Grouping >

getRowGroupColumns : 행 그룹 열을 가져옵니다.

setRowGroupColumns : 행 그룹 열을 설정합니다.

addRowGroupColumn : 행 그룹에 열을 추가합니다.

addRowGroupColumns : addRowGroupColumn 과 동일 하지만 열 목록을 제공합니다.

removeRowGroupColumn : 행 그룹에서 열을 제거합니다.

removeRowGroupColumns : removeRowGroupColumn 과 동일 하지만 열 목록을 제공합니다.

moveRowGroupColumn : 행 그룹화 순서에서 열을 새 위치로 이동합니다.


< Sizing >


< State >


< Value Columns >


< Visibility and Display >